67 7
1111111111111111111111111111111111111111111111111111111111111111111
1000000000000000000000000000000000000000000000000000000000000000001
1010011111111011101001111101100101111011010011111011011100100001101
100001e100000010110100100000100010100100100000100010101110110000111
1010010111111011101011011111101101101011011111111011101000000001111
1m00010000000001011010010000010001010010010000010001010011111111101
1111111111111111111111111111111111111111111111111111111111111111111