7 7
1000001
1000001
1001111
1000000
1100001
10001m1
1111111