17 16
11111111111111111
10000000m00000001
11111111011111111
10000000000000001
11111111011111111
10000000000000001
11111111011111111
10000000000000001
11111111011111111
10000000000000001
11111111011111111
10000000000000001
11111111011111111
10000000000000001
11111111011111111
11111111e11111111