7 7
1000001
1000001
10e1111
1000000
1100011
1000101
1111111