16 8
1111111111111111
1m10101010101011
1010101010101011
1010101010101011
1000000000000001
1010101010101011
101010101010100e
1111111111111111