17 17
11111111e11111111
10000000000000001
10000000000000001
10000100000100001
10001000000010001
10010000000001001
10100000000000101
11000000000000011
11000000000000011
10100000000000101
10010000000001001
10001000000010001
10000100000100001
10000000000000001
11111100000111111
10000000000000001
111111111111111m1