16 8
1111111111111111
1m1e101010101011
1010101010101011
1010101010101011
1000000000000001
1010101010101011
1010101010101001
1111111111111111