16 8
1111111111111e11
1m10101010101011
1010101010101011
1010101010101011
1000000000000001
1010101010101011
1010101010101001
1111111111111111