16 7
1111111111111111
1000000000000001
1010011111111011
100001e100000010
1010010111111011
1m00010000000001
1111111111111111