11 8
111m1111111
10000010001
11101110101
10000000101
11101111101
10000000001
111111111e1