11111111111111111111111111111111111111111
10100000010000000000000000000000000010001
10101101010100000000000111111100010010101
10101101010100001000000111111100010010101
10101101010100001000000000000000010010101
10101101010100001000000000000000010010101
10101101010100001110000000000001110010101
100000010001000000000m0000000000000000101
111111111111111111111111111111111111111e1