11111111111111111111111111111111111111111
1m100000010001000001000110000001000010001
10110010010100001001000111111101010010101
10100110110100001001000111111101010010101
10110010010100001000000000001101010010101
10100111010101101011000001000001010010101
10110010010100101011000001001101010010101
10100110110100100011000001001100010010101
10110010010100100011110001001100110010101
10000110000100100000000001001100010000101
111111111111111111111111111111111111111e1